####################
# p    &* *    *   #
# # # #^# # #*#*#1##
#  1      ***   *  #
# # # # # #*# # #*##
#f           **  * #
# # # # # # # # # ##
#*  *      *  *    #
# # # # #*# # # #*##
#*    **  *       *#
# #*# # # # # # #*##
#  x#       *   *  #
#*  * * * #     #  #
#   #     *   1    #
####################